##############
#   # .......#
# A # .#####.#
# .....#  ##.#
######### #..#
#        B#.##
# ######..#..#
#   #  #.###.#
#   #   .....#
##############
